# Map file for tile-based game
# (Lines that start with '#' are comments)
# The tiles are:
#   (Space) Empty tile
#   S    coin
#   R    Diamond   
#   N    gold key
#   O    silver key
#   U    enemy ghost sprite
#   P    Door                            
D                                       S U O T               TO                    C
D                            S M     I FKBBBBBBL             KBBL                   C
D                            S M                                 R    I   I         C
D      SSSS         III     FKBBBL              S    P                          U   C
D RS  IIIIIII    I                           S    FKBL                       KBBBL  C
D II                               S   S   S   S                                    C
D                      SS          I   I   I   I                     KBBBL          C
D        SS   BB    S      N         O     U                   KL    CAAAD        P C
BBBBBL KBBBGD AABBBBBBBBBBBBBBGD  CHBBBBBBBBBBBBBBBBGD   KBL   CD    CAAAD          C